APROX			AH P R OW K S
STOCKI			S T OW K IY
AMPRADIOSA		AE M P R AE D IY OW S AH
ARTANNULATUS		AA R T AE N AH L EY T AH Z
AXIRREGULAR		AE K S IH R EH G Y AH L ER
BGRAN			B IY G R AE N
CRYPTBUSS		K R IH P T B AH S
GONDWANA		G AO N D W AE N AH
LOPHOHADRA		L OW F AH HH AE D R AH
MITA			M IY T AH
PODPAPILIS		P AA D P AE P IH L IH S
PSEUDODICT		S UW D OW D IH K T
ZYGO			S IY G ER
SPYRO			S P IY R ER
CORNUTELLA		K AO R N Y UH T EH L AH
CALOCYCLAS		K AE L OW S AY K L AH Z
BUNNYEARS		B AH N IY IH R Z
ZIGZAG			Z IH G Z AE G
ACROSTOMA		AH K R AO S T AH M AH
BICORNE			B IH K AO R N
BOREALIS		B AO R IY AE L AH S
CIRCUMTEXTA		S ER K AH M T EH K S T AH
CYRTODON		S IH R T AH D AO N
DELICATULUM		D EH L AH K AH T UW L AH M
EMMAE			EH M EY
HUXLEYI			HH AH K S L IY
LAPPACEA		L AE P AH S IY AH
LEPTODERMUM		L EH P T AH D ER M AH M
MEDIANUM		M IY D IY AH N AH M
NANA			N AE N AH
OCTOPYLE		AA K T OW P AH L IY
OPHIRENSE		OW F AY R AH N Z
PINCHUDA		P IH N CH UW D AH
SETOSA			S IY T OW S AH
SOL			S OW L
STRAUSSI		S T R AW S IY
UMBELLIFERA		AH M B AH L IH F ER AH
YPSILON			IH P S AH L AA N
REMOVE			R IY M UW V
STOP			S T AA P
